11111111111111111
10000000000000001
1000C000010000001
10000000000000C01
10000000010000001
1E000000000000001
10000000000000001
11111000000000001
10000000000000001
10000000000000001
10000000000000001
10000000000C00001
10000C00001100001
10000000001P10011
11111111110111111