1111111111111111111111111111
1000000000000000000000000001
10000000C0000000000000000001
1000000000000000000000000001
1000C00000C00000000000000001
1000000000000000000000000001
1000000000000000000000000001
1000000000000000000S00000001
10000C0000000000000000000001
1000000000000000000000000001
1000000000000000000000000001
100000C00000000000C000000E01
10000000000000C0000000000001
100000C000000000000000111111
1000000000000000000000000001
1000000000000000000000000001
100000000C000000000000000001
1000000000000000000000000001
1000000000000000000000000001
1000000000000001111111111111
1000000000000000000000000001
1000000000000000000000000001
1000000000000000000000000001
1000000000000000000000000001
10000000000000000000000000P1
10000000000000000000000000C1
1111111111111111111111111111
