11111111111111111
10000000000000001
1000C000000000001
100000000P0000C01
100000000C0000001
1E000000000000001
10000000000C00001
10000C00000000001
10000000000000001
11111111111111111
