1111111111111111111111111111
1000000000000000000000000001
1000000000000000000000000001
1000000000000000000000000001
1000000000000000000000000001
1000000000000000000000000001
1000000000000000000000000001
1000000000000000000S00000001
1000000000000000000000000001
1000000000000000000000001111
1000000000000001111111111
1000000000000000000000001111
1000000000000000000000000111
10000000000000000000001111P1
1000000000000000000000000111
1000000000000000000000000001
1000000000000100000000000001
1000000000000000000000000001
1000000000000000000000000001
1000000000000001111111111111
1000000000000000000000000001
1000000000000000000000000001
1000000000000000000000000001
1000000000000000000000000001
1000000000000000000000000001
1000000000000000000000000001
1111111111111111111111111111
