111111
1C0001
100001
1EC001
1C0001
1C0001
1C0001
1C0001
1C0S01
1E00P1
111111
